11111111111111
10000001000001
10C1000000C001
1000000P000001
10000111100001
100011E000C001
11111111111111