11111111111111
1001000000C001
10000111100011
1P0011E0000001
11111111111111