11111111111111
10000001000001
10010000000001
10000000000001
1000011110P001
100011E000C001
11111111111111
