11111111111111
1000C001000001
10010000000001
10C000E0000001
1000000000P001
1000000000C001
11111111111111