11111111111111
11111111111111
11111111111111
11111111111111
11111111111111

[0][0] = 1, [0][1] = 1