11111111111
10000000001
10000000000
1000000P001
10000000001
11111111111