11111111111
10000000001
10000000001
1000000P001
10000000001
11111110111